OOOOOOONOOOOOOOOOOOOO
O.............Ttt5T.O
O>....B>...h..TtTTT.O
O>.............H....O
O........JKL........O
O..V.mm....HHH....uuO
OOOOOOOOOOOOOOOOOOOOO

0-0-CORRIDOR_UC-0
0-0-0-0
0
There are toys and children's books all over the place.
