#####################
#======_============#
#======N====h=======#
#.............Ttt5T.#
#>....B>...h..TtTTT.#
#>.............H....#
#........JKL........#
#..V.mm....HHH....uu#
#===================#

D|0-0-CORRIDOR_UC-0
S|0-0-0-0
K|0-0-0-0
L|0
C|There are toys and children's books all over the place.
