OOOOOOOOOOOOOOOOOTTTTTTTTOOOOOOOOOOOOOOOOOO
OII..............I......I...............OOO
O...............................HH......OOO
O.....TTTTT..............................iO
O...[.TtttT.]..............B>...TT...<B..iO
O.....TtTtT................B>...TT...<B..iO
O...[.ttT3T.]..............B>...TT...<B..iO
O.....TTTTT..............................iO
O...............................HH......OOO
OII.....................................OOO
OOOOOOOOOOSSOOOOOOOOOOOOOOOOOOOSSOOOOOOOOOO

0-0-0-HALL
0-0-0-0
0
This is a neatly arranged room with lots of comfy stuff to sit on.\It also looks quite pretty with the fireplace and all.\You wish you could be their guest sometime.\...\...oh, right.
