###########################################
#==----============TTTT=============----==#
#==----============TTTT=============----==#
#================TTT##TTT=================#
#II..............I......I...............OO#
#...............................HH......OO#
#.....TTTTT..............................i#
#...[.TtttT.]..............B>...TT...<B..i#
#.....TtTtT................B>...TT...<B..i#
#...[.ttT3T.]..............B>...TT...<B..i#
#.....TTTTT..............................i#
#...............................HH......OO#
#II.....................................OO#
#=========SS===================SS=========#

D|0-0-0-HALL
S|0-0-0-0
K|0-0-0-0
L|0
C|This is a neatly arranged room with lots of comfy stuff to sit on.\It also looks quite pretty with the fireplace and all.\You wish you could be their guest sometime.\...\...oh, right.
